tileset_2
25
20
1
12 12 12 12 12 12 12 12 12 12 1 2 2 3 12 12 12 12 12 1 0 0 0 52 53
22 22 22 22 22 22 22 22 22 22 11 12 12 13 22 22 22 22 22 11 1 2 2 62 63
32 32 32 32 32 32 32 32 32 32 21 22 22 23 32 32 32 32 32 21 11 12 12 12 1
0 0 0 0 0 0 0 0 0 0 31 32 32 33 0 0 0 0 0 31 21 22 22 22 11
0 0 0 0 0 0 0 0 0 0 0 0 0 0 0 0 0 0 0 0 31 32 32 32 21
0 0 0 0 0 0 0 0 0 0 0 0 0 0 0 0 0 0 0 0 0 0 0 0 31
0 0 0 0 0 0 0 0 0 0 0 0 0 0 0 0 0 0 0 0 0 0 0 0 0
43 0 0 0 0 0 0 0 0 0 0 0 0 0 0 0 0 0 0 0 0 0 0 0 0
10 0 0 0 0 0 0 0 0 0 0 0 0 0 0 0 0 0 0 0 0 0 0 0 0
10 0 0 0 0 0 0 0 0 0 0 0 0 0 0 0 0 0 0 0 0 0 0 0 0
10 0 0 0 0 0 0 0 0 0 0 0 0 0 0 0 0 0 0 0 0 0 0 0 0
10 0 0 0 0 0 0 0 0 0 0 0 0 0 0 0 0 0 0 0 0 0 0 0 0
10 0 0 0 0 0 0 0 0 0 0 0 0 0 0 0 0 0 0 0 0 0 0 0 0
10 0 0 0 0 0 0 0 0 0 0 0 0 0 0 0 0 0 0 0 0 0 0 0 0
10 0 0 0 0 0 0 0 0 0 0 0 0 0 0 0 0 0 0 0 0 0 0 0 0
10 0 0 0 0 0 0 0 0 0 0 0 0 0 0 0 0 0 0 0 0 0 0 0 0
10 0 0 0 0 0 41 42 42 42 42 42 43 0 0 0 0 0 0 0 0 0 0 0 0
10 0 0 0 0 41 0 0 0 0 0 0 0 43 0 0 0 0 0 0 0 0 41 42 43
10 0 0 0 41 0 0 0 0 0 0 0 0 0 43 0 0 0 0 0 0 41 0 0 0
0 42 42 42 0 0 0 0 0 0 0 0 0 0 0 42 42 42 42 42 42 0 0 0 0

