tileset_1
20
15
-
-
5  5  5  5  5  5  5  5  5  5  5  5  5  5  5  5  5  5  5  5
5  2  3  3  4  5  2  3  3  3  3  3  3  5  3  17 18 19 4  5
5  7  8  8  9  5  7  8  8  8  8  8  8  5  8  22 5  24 9  5
5  12 13 13 14 5  12 13 13 13 13 13 13 5  13 27 28 29 14 5
5  0  0  0  0  5  0  0  0  0  0  0  0  5  0  32 0  34 0  5
5  0  0  0  0  5  0  0  0  0  0  0  0  5  0  0  0  0  0  5
5  0  0  0  0  5  0  0  0  0  0  0  0  25 0  0  0  0  0  5
5  0  0  0  0  5  0  0  0  5  0  0  0  30 0  0  0  0  0  5
5  0  0  0  0  5  0  0  0  5  0  0  0  35 0  0  0  0  0  5
5  0  0  0  0  25 0  0  0  5  0  0  0  0  0  0  0  0  0  5
5  0  0  0  0  30 0  0  0  5  0  0  0  0  0  0  0  0  0  5
5  0  0  0  0  35 0  0  0  5  0  0  0  0  0  0  0  0  0  5
5  0  0  0  0  0  0  0  0  5  0  0  0  0  0  0  0  0  0  5
5  0  0  0  0  0  0  0  0  5  0  0  0  0  0  0  0  0  0  5
5  5  5  5  5  5  5  5  5  5  5  5  5  5  5  5  5  5  5  5
-
-
[GEGNER]
1: 20,20,100,5
2: 30,30,1000,100
[MUSIK]
/res/music/music1.mp3
