tileset_2
20
15
3
0  0  0  0  0  0  0  0  0  0  0  0  0  0  0  0  0  0  0  0
0  0  0  0  0  0  0  0  0  0  0  0  0  0  0  0  0  0  0  0
0  0  0  0  0  0  0  0  0  0  0  0  0  0  0  0  0  0  0  0
0  0  0  0  0  0  0  0  0  0  0  0  0  0  0  0  0  0  0  0
0  0  0  0  0  0  0  0  0  0  0  0  0  0  0  0  0  0  0  0
0  0  0  0  0  0  0  0  0  0  0  0  0  0  0  0  0  0  0  0
0  0  0  0  0  0  0  0  0  0  0  0  0  0  0  0  0  0  0  0
0  0  0  0  0  0  0  0  0  0  0  0  0  0  0  0  0  0  0  0
0  0  0  0  0  0  0  0  0  0  0  0  0  0  0  0  0  0  0  0
0  0  50 51 0  0  0  0  0  0  0  0  0  0  0  0  0  0  0  0
0  0  60 61 0  0  0  0  0  0  0  0  0  0  0  0  0  0  0  0
0  0  52 53 0  0  0  0  0  0  0  0  0  0  0  0  0  0  0  0
0  0  62 63 50 51 0  0  0  0  0  0  0  0  0  0  0  0  0  0
0  0  0  0  60 61 0  0  0  0  0  0  0  0  0  0  0  0  0  0
0  0  0  0  52 53 0  0  0  0  0  0  0  0  0  0  0  0  0  0

5  5  5  5  5  5  5  5  5  5  5  5  5  5  5  5  5  5  5  5
5  5  5  5  5  5  5  5  5  5  5  5  5  5  5  5  5  5  5  5
5  5  5  5  5  5  5  5  5  15 5  5  5  5  5  5  5  5  5  5
5  5  5  5  5  5  5  5  5  5  5  5  5  5  5  5  5  5  5  5
5  5  5  5  5  5  5  5  5  5  5  5  5  5  5  5  5  5  5  5
5  5  5  5  5  5  5  5  5  5  5  5  15 5  5  5  5  5  5  5
5  5  27 28 5  5  5  5  5  5  5  5  5  5  5  5  5  5  5  5
5  5  37 38 5  5  5  5  5  5  5  5  5  5  5  5  5  5  5  5
5  25 47 48 26 5  5  5  5  5  5  5  5  5  5  5  5  5  5  5
5  35 5  5  36 5  5  5  5  5  5  5  5  5  5  5  5  5  5  5
5  45 5  5  46 5  5  5  5  5  5  5  5  5  5  5  5  5  5  5
5  55 5  5  56 5  5  5  5  5  5  5  5  5  5  5  5  5  5  5
5  5  5  5  5  5  5  5  5  5  5  5  5  5  5  5  5  5  5  5
5  5  5  5  5  5  5  5  5  5  5  5  5  5  5  5  5  5  5  5
5  5  5  5  5  5  5  5  5  5  5  5  5  5  5  5  5  5  5  5

5  5  5  5  5  5  5  5  5  5  5  5  5  5  5  5  5  5  5  5
5  5  5  5  5  5  5  5  5  5  5  5  5  5  5  5  5  5  5  5
5  5  5  5  5  5  5  5  5  5  5  5  5  5  5  5  5  5  5  5
5  5  5  5  5  5  5  5  5  5  5  5  5  5  5  5  5  5  5  5
5  5  5  5  5  5  5  5  5  5  5  5  5  5  5  5  5  5  5  5
5  5  5  5  5  5  5  5  5  5  5  5  5  5  5  5  5  5  5  5
5  5  5  5  5  5  5  5  5  5  5  5  5  5  5  5  5  5  5  5
5  5  5  5  5  5  5  5  5  5  5  5  5  5  5  5  5  5  5  5
5  5  5  5  5  5  5  5  5  5  5  5  5  5  5  5  5  5  5  5
5  5  5  5  27 28 5  5  5  5  5  5  5  5  5  5  5  5  5  5
5  5  5  5  37 38 5  5  5  5  5  5  5  5  5  5  5  5  5  5
5  5  5  25 47 48 26 5  5  5  5  5  5  5  5  5  5  5  5  5
5  5  5  35 5  5  36 5  5  5  5  5  5  5  5  5  5  5  5  5
5  5  5  45 5  5  46 5  5  5  5  5  5  5  5  5  5  5  5  5
5  5  5  55 5  5  56 5  5  5  5  5  5  5  5  5  5  5  5  5
-
-