tileset_3
20
15
2
35 58 58 58 58 58 56 58 58 58 58 58 58 58 58 58 58 58 58 36
49 1  31 30 33 2  67 2  2  2  2  2  2  2  2  2  2  2  3  47
49 11 61 62 63 12 67 12 12 12 12 12 12 4  5  6  12 12 13 47
49 21 71 72 73 22 67 22 22 22 22 22 22 14 15 16 22 22 23 47
49 0  10 0  20 0  67 0  0  0  0  0  0  24 25 26 0  0  0  47
49 0  0  0  0  0  67 0  0  0  0  0  0  0  0  0  0  0  0  47
49 0  0  0  0  0  67 0  0  0  0  0  0  0  0  0  0  0  0  47
49 0  0  0  0  0  67 0  0  0  0  0  89 68 68 68 68 68 68 60
49 0  0  0  0  0  87 0  0  0  0  0  1  2  2  2  2  2  3  57
49 0  0  0  0  0  76 0  0  0  0  0  11 12 12 12 12 12 12 1
49 0  0  0  0  0  86 0  0  0  0  0  21 22 22 22 22 22 23 11
49 0  0  0  0  0  96 0  0  0  0  0  0  0  0  0  0  0  0  12
49 0  0  0  0  0  0  0  0  0  0  0  0  0  0  0  0  0  0  0
49 0  0  0  0  0  0  0  0  0  0  0  0  0  0  0  0  0  0  37
45 38 38 38 38 38 38 38 38 38 38 38 38 38 38 38 38 38 38 46

99 99 99 99 99 99 99 99 99 99 99 99 99 99 99 99 99 99 99 99
99 99 99 99 99 99 99 99 99 99 99 99 99 99 99 99 99 99 99 99
99 99 99 99 99 99 99 99 99 99 99 99 99 99 99 99 99 99 99 99
99 99 99 99 99 99 99 99 99 99 99 99 99 99 99 99 99 99 99 99
99 99 99 99 99 99 99 99 99 99 99 99 99 99 99 99 99 99 99 99
99 99 99 99 99 99 99 99 99 99 99 99 99 99 99 99 99 99 99 99
99 99 99 99 99 99 99 99 99 99 99 99 99 99 99 99 99 99 99 99
99 99 99 99 99 99 99 99 99 99 99 99 99 99 99 99 99 99 99 99
99 99 99 99 99 99 99 7  8  8  8  9  99 99 99 99 99 99 99 99
99 99 99 99 99 99 99 17 19 99 17 19 99 99 99 99 99 99 99 99
99 99 99 99 99 99 99 27 29 99 27 29 99 99 99 99 99 99 99 99
99 99 99 99 99 99 99 99 99 99 99 99 99 99 99 99 99 99 99 99
99 99 99 99 99 99 99 99 99 99 99 99 99 99 99 99 99 99 99 99
99 99 99 99 99 99 99 99 99 99 99 99 99 99 99 99 99 99 99 99
99 99 99 99 99 99 99 99 99 99 99 99 99 99 99 99 99 99 99 99