tileset_1
11
15
-
-
5  5  5  5  5  5  5  5  5  5  5
5  2  3  3  3  3  3  3  3  3  5
5  7  8  8  8  8  8  8  8  8  5
5  12 13 13 13 13 13 13 13 13 5
5  0  0  0  0  0  0  0  0  0  5
5  0  0  0  0  0  0  0  0  0  5
5  0  0  0  0  0  0  0  0  0  5
5  0  0  0  0  0  0  0  0  0  5
5  0  0  0  0  0  0  0  0  0  5
5  0  0  0  0  0  0  0  0  0  5
5  0  0  0  0  0  0  0  0  0  5
5  0  0  0  0  0  0  0  0  0  5
5  0  0  0  0  0  0  0  0  0  5
5  0  0  0  0  0  0  0  0  0  5
5  5  5  5  5  5  5  5  5  5  5
-
-
[GEGNER]
1: 20,20,100,5
2: 30,30,1000,100
[MUSIK]
/res/music/music1.mp3
