tileset_1
25
20
1
2 2 4 4 2 3 3 4 3 2 3 2 3 2 4 4 3 4 2 3 4 32 33 34 4
13 13 13 13 14 14 13 12 14 14 12 14 13 14 14 14 12 13 12 14 12 42 43 44 14
24 24 24 24 23 30 31 22 22 24 23 23 23 24 23 24 23 23 22 24 22 52 53 54 24
73 72 73 73 73 40 41 73 73 73 73 73 73 73 73 73 73 73 73 73 74 62 0 64 0
0 0 1 1 1 1 1 1 1 1 1 1 1 1 1 1 1 1 1 1 1 11 11 11 0
11 0 1 1 1 1 1 1 1 1 1 1 1 1 1 1 1 1 1 1 1 73 73 73 0
74 0 1 1 1 1 1 1 1 1 1 1 1 1 1 1 1 1 1 1 1 1 1 1 0
1 0 1 1 1 1 1 1 1 1 1 1 1 1 1 1 1 1 1 1 1 1 1 1 0
1 0 1 1 1 1 1 1 1 1 1 1 1 1 1 1 1 1 1 1 1 1 1 1 0
1 0 1 1 1 1 1 1 1 1 1 1 1 1 1 1 1 1 1 1 1 1 1 1 0
1 0 0 0 0 0 0 0 0 0 0 0 0 0 0 0 0 0 0 0 0 0 0 0 0
1 0 0 0 0 0 0 0 0 0 0 0 0 0 0 0 0 0 0 0 0 0 0 0 0
1 11 20 11 20 20 20 11 11 20 20 20 11 11 20 20 11 20 20 11 11 20 11 11 20
1 73 73 73 73 73 73 73 73 73 73 73 73 73 73 73 73 73 73 73 73 73 73 73 73
1 1 1 1 1 1 1 1 1 1 1 1 1 1 1 1 1 1 1 1 1 1 1 1 1
1 1 1 1 1 1 1 1 1 1 1 1 1 1 1 1 1 1 1 1 1 1 1 1 1
1 1 1 1 1 1 1 1 1 1 1 1 1 1 1 1 1 1 1 1 1 1 1 1 1
1 1 1 1 1 1 1 1 1 1 1 1 1 1 1 1 1 1 1 1 1 1 1 1 1
1 1 1 1 1 1 1 1 1 1 1 1 1 1 1 1 1 1 1 1 1 1 1 1 1
1 1 1 1 1 1 1 1 1 1 1 1 1 1 1 1 1 1 1 1 1 1 1 1 1
